####################################################################################################
####################################################################################################
####################################################################################################
####################################################################################################
##################################....................................##############################
##################################....................................##############################
##################################..########..########..########..##################################
##################################..########..########..########..##################################
##################################..########..########..########..##################################
##################################..########..########..########..##################################
##################################..########..########..########..##################################
##################################..########..########..########..##################################
##################################..########..########..########..##################################
##################################..########..########..########..##################################
########################........................................................####################
########################........................................................####################
########################..########................................########..########################
########################..########................................########..########################
########################..########................................########..########################
########################..########................................########..########################
##################################................................########..########################
##################################................................########..########################
##################################................................########..########################
##################################................................########..########################
##############################..................................................####################
##############################..................................................####################
##################################................................##################################
##################################................................##################################
##################################................................##################################
##################################................................##################################
##################################................................##################################
##################################................................##################################
##################################................................##################################
##################################................................##################################
##############################..............................................########################
##############################..............................................########################
##################################................................########..########################
##################################................................########..########################
##################################................................########..########################
##################################................................########..########################
##################################................................##################################
##################################................................##################################
##################################................................##################################
##################################................................##################################
########################........................................................####################
########################........................................................####################
########################..########..########..########..########..########..########################
########################..########..########..########..########..########..########################
########################..########..########..########..########..########..########################
########################..########..########..########..########..########..########################
########################..########..############################..########..########################
########################..########..############################..########..########################
########################..########..############################..########..########################
########################..########..############################..########..########################
########################..########..####..........####......................########################
########################..########..####..........####......................########################
########################..########..########..########..########..########..########################
########################..########..########..########..########..########..########################
########################..########..########..########..########..########..########################
########################..########..########..########..########..########..########################
##############..########..########..########..########..########..########..########..########..####
##############..########..######......######..########..########..########..########..########..####
##############..########..#####........#####..########..########..########..########..########..####
##############..########..#####..@..@..#####..########..########..########..########..########..####
##############......####...........................................................................#
##############......####...........................................................................#
##############..########..#####..@..@..#####............########................................####
##############..########..#####........#####............########................................####
##############..########..######......######............########................................####
##############..########..########..########............########................................####
####..########..########..########..########............########................................####
####..########..########..########..########............########................................####
####..########..########..########..########............########................................####
####..########..########..########..########............########................................####
#..................................................................................................#
#..................................................................................................#
##############............##################..########..########................................####
##############............##################..########..########................................####
##############............##################..########..########................................####
##############............##################..########..########................................####
##############............########..########..########..########................................####
##############............########..########..########..########................................####
##############............########..########..########..########................................####
##############............########..########..########..########................................####
##########..........................########..########..####.......................................#
##########..........................########..########..####.......................................#
##############..########..########..########..########..########................................####
##############..########..########..########..########..########................................####
##############..########..########..########..########..########................................####
##############..########..########..############################................................####
##############..########..########..########..########..########................................####
##############..########..########..########..########..########................................####
##############..########..########..########..########..########................................####
##############..########..########..########..########..########................................####
##############..####...............................................................................#
##############..####...............................................................................#
##############..########................................########..########..########..########..####
##############..########................................########..########..########..########..####
##############..########................................########..########..########..########..####
########################................................########..########..########..########..####
########################................................############################################
########################................................############################################
########################................................############################################
########################................................############################################
####################........................................########################################
####################........................................########################################
########################................................############################################
########################................................############################################
########################................................############################################
########################................................############################################
########################................................############################################
########################................................############################################
########################................................############################################
########################................................############################################
####################........................................########################################
####################........................................########################################
########################................................############################################
########################................................############################################
########################................................############################################
########################................................############################################
########################................................############################################
########################................................############################################
########################................................############################################
########################................................############################################
####################........................................########################################
####################........................................########################################
########################..########..########..########..############################################
########################..########..########..########..############################################
########################..########..########..########..############################################
####################################################################################################
