######################################################################################################################################################
################################################################..########..##########################################################################
################################################################..########..##########################################################################
################################################################..########..##########################################################################
################################################################............##########################################################################
################################################################............##########################################################################
################################################################..########..##########################################################################
################################################################..########..##########################################################################
################################################################..########..##########################################################################
################################################################..########..##########################################################################
##################################..############################..########..##########################################################################
##################################..############################..########..##########################################################################
##################################..############################..########..##########################################################################
##################################..############################..########..##########################################################################
##############################..........................####.......................................##...............####......####..........##########
##############################..........................####.......................................##...............####......####..........##########
############################################..########..########..########..########..############################..########..########..##############
############################################..########..########..########..########..############################..########..########..##############
############################################..########..########..########..########..############################..########..########..##############
############################################..########..########..########..########..############################..########..########..##############
######################################################..##################..######################################..########..########..##############
######################################################..##################..######################################..########..########..##############
######################################################..##################..######################################..########..########..##############
######################################################..##################..######################################..########..########..##############
############################################..........................####......................##################............########..##############
############################################..........................####......................##################............########..##############
############################################..########..##################..##################..##################..########..########..##############
############################################..########..##################..##################..##################..########..########..##############
############################################..########..##################..##################..##################..########..########..##############
############################################..########..##################..##################..##################..########..########..##############
############################################..########..##################..##################..##################..########..########..##############
####..##################..##################..########..##################..##################..########..########..########..########..##############
####..##################..##################..########..##################..##################..########..########..########..########..##############
####..##################..##################..########..##################..##################..########..########..########..########..##############
####..##################..##################.........................#####..##################......####..####......########......................####
####..##################..##################.........................#####..##################......####..####......########......................####
####..##################..##################..########..##################..##################..########..########..########..########..########..####
####..##################..##################..########..##################..##################..########..########..########..########..########..####
####..##################..##################..########..##################..##################..########..########..########..########..########..####
####..##################..##################..########..######################################..########..########..########..########..########..####
####..##################..##################..########..########..############################..########..########..########..########..########..####
####..##################..##################..########..########..##################..########..########..########..########..########..########..####
####..##################..##################..########..########..##################..########..########..########..########..########..########..####
####..##################..##################..########..########..##################..########..########..########..########..########..########..####
####......................##################..########............##################..########................................####......####.........#
####......................##################..########............##################..########................................####......####.........#
##############..########..##################..########..############################..########..########..########..########..########..########..####
##############..########..##################..########..############################..########..########..########..########..########..########..####
##############..########..##################..########..############################..########..########..########..########..########..########..####
##############..########..##################..########..############################..########..########..########..########..########..########..####
##############..########..##################..######################################..########..########..########..########..########..##############
##############..########..##################..########..############################..########..########..########..########..########..##############
##############..########..##################..########..############################..########..########..########..########..########..##############
##############..########..##################..########..############################..########..########..########..########..########..##############
##############......####..........................####..#####...............####................########......................########......##########
##############......####..........................####..#####...............####................########......................########......##########
##############..##################..########..########..##################..########..########..########..########..########..########################
##############..##################..########..########..##################..########..########..########..########..########..########################
##############..##################..########..########..##################..########..########..########..########..########..########################
##############..##################..########..########..##################..########..########..########..########..########..########################
####..########..##################..########..########..##################..########..########..########..########..########..########################
####..########..##################..########..########..##################..########..########..########..########..########..########################
####..########..##################..########..########..##################..########..########..########..########..########..########################
####..########..##################..########..########..##################..########..########..########..########..########..########################
####............##################......................########......####............####......########......................########################
####............##################......................########......####............####......########......................########################
####..######################################..########..########..########..########..############################..##################################
####..######################################..########..########..########..########..############################..##################################
####..######################################..########..########..########..########..############################..##################################
####..######################################..########..########..########..########..############################..##################################
######################################################..########..########..########..########..##################..##################..##############
######################################################..########..########..########..########..##################..##################..##############
######################################################..########..########..########..########..##################..##################..##############
######################################################..########..########..########..########..##################..##################..##############
############################################..........................####..####................##################..........................##########
############################################..........................####..####................##################..........................##########
############################################..##################..########..########..############################..########..########################
############################################..##################..########..########..############################..########..########################
############################################..##################..########..########..############################..########..########################
############################################..##################..########..########..############################..########..########################
############################################..########..########..########..############################..########..########..########################
############################################..########..########..######......##########################..########..########..########################
############################################..########..########..#####........#########################..########..########..########################
############################################..########..########..#####..@..@..#########################..########..########..########################
############################################............########................................########..........................####################
############################################............########................................########..........................####################
################################################################..#####..@..@..###############..############################..########################
################################################################..#####........###############..############################..########################
################################################################..######......################..############################..########################
################################################################..########..##################..############################..########################
################################################################..########..##################..######################################################
################################################################..########..##################..######################################################
################################################################..########..##################..######################################################
################################################################..########..##################..######################################################
################################################################..########......................######################################################
################################################################..########......................######################################################
################################################################..##################..########..######################################################
################################################################..##################..########..######################################################
################################################################..##################..########..######################################################
####################################################################################..########..######################################################
####################################################################################..########..######################################################
####################################################################################..########..######################################################
####################################################################################..########..######################################################
####################################################################################..########..######################################################
####################################################################################............######################################################
####################################################################################............######################################################
##############################################################################################..######################################################
##############################################################################################..######################################################
##############################################################################################..######################################################
##############################################################################################..######################################################
##############################################################################################..######################################################
##############################################################################################..######################################################
##############################################################################################..######################################################
##############################################################################################..######################################################
#################################################################################...............######################################################
#################################################################################...............######################################################
##############################################################################################..######################################################
##############################################################################################..######################################################
##############################################################################################..######################################################
##############################################################################################..######################################################
##############################################################################################..######################################################
##############################################################################################..######################################################
##############################################################################################..######################################################
##############################################################################################..######################################################
##############################################################################################..######################################################
##############################################################################################..######################################################
##############################################################################################..######################################################
##############################################################################################..######################################################
##############################################################################################..######################################################
##############################################################################################..######################################################
##############################################################################################..######################################################
##############################################################################################..######################################################
##############################################################################################..######################################################
##############################################################################################..######################################################
##############################################################################################..######################################################
##############################################################################################..######################################################
##############################################################################################..######################################################
##############################################################################################..######################################################
##############################################################################################..######################################################
######################################################################################################################################################

